R1A1A1ARR
RA1ARA1AR
A1R1A1R1A
1A1A1A1A1
A1A1R1A1A
1A1A1A1A1
A1R1A1R1A
RA1ARA1AR
RRA1A1A1R