11AAAAA11
1AAA1AAA1
1AA111AA1
AA11111AA
A1111111A
AA11111AA
1AA111AA1
1AAA1AAA1
11AAAAA11