RR1ARRRRR
R1A1ARRRR
RA1A1A1RR
R1A1A1A1A
1A1A0A1A1
A1A1A1A1R
RR1A1A1AR
RRRRA1A1R
RRRRRA1RR