11AA1AA11
1AAAAAAA1
AA11A11AA
A1111111A
A1111111A
AA11111AA
AAA111AAA
1AAA1AAA1
11AARAA11