RRRRRRRRR
RR1RRRRRR
R1A1ARRRR
RR1ARRRRR
RRRRRRRRR
RRRRRRRRR
RRRRRRRRR
RRRRRRRRR
RRRRRRRRR