RRRRRRRRR
RRRRRRRRR
RRRRRRRRR
RRR1RRRRR
RRA1DARRR
RRR1RRRRR
RRRRRRRRR
RRRRRRRRR
RRRRRRRRR