A1ARRRRRR
101RRRRRR
A1ARRRRRR
RRRRRRRRR
RRRRRRRRR
RRRRRRRRR
RRRRRRRRR
RRRRRRRRR
RRRRRRRRR